[bmcmanager.entrypoints]
check disks = bmcmanager.commands.disks:Check
check firmware = bmcmanager.commands.firmware:Check
check ram = bmcmanager.commands.ram:Check
check sensor = bmcmanager.commands.ipmi.sensor:Check
disks check = bmcmanager.commands.disks:Check
disks get = bmcmanager.commands.disks:Get
firmware check = bmcmanager.commands.firmware:Check
firmware get = bmcmanager.commands.firmware:Get
firmware latest check = bmcmanager.commands.firmware:LatestCheck
firmware latest get = bmcmanager.commands.firmware:LatestGet
firmware refresh = bmcmanager.commands.firmware:Refresh
firmware upgrade osput = bmcmanager.commands.firmware:UpgradeOsput
firmware upgrade rpc = bmcmanager.commands.firmware:UpgradeRPC
ipmi address get = bmcmanager.commands.ipmi.address:Get
ipmi address refresh = bmcmanager.commands.ipmi.address:Refresh
ipmi credentials get = bmcmanager.commands.ipmi.credentials:Get
ipmi credentials set = bmcmanager.commands.ipmi.credentials:Set
ipmi logs clear = bmcmanager.commands.ipmi.logs:Clear
ipmi logs get = bmcmanager.commands.ipmi.logs:Get
ipmi reset = bmcmanager.commands.ipmi.reset:Reset
ipmi sensor check = bmcmanager.commands.ipmi.sensor:Check
ipmi sensor get = bmcmanager.commands.ipmi.sensor:Get
ipmi ssh = bmcmanager.commands.ipmi.ssh:SSH
ipmi tool = bmcmanager.commands.ipmitool:Run
lenovo rpc do = bmcmanager.commands.lenovo:Do
lenovo rpc list = bmcmanager.commands.lenovo:List
netbox secret list = bmcmanager.commands.netbox:ListSecrets
netbox secret set = bmcmanager.commands.netbox:SetSecret
open console = bmcmanager.commands.open:Console
open dcim = bmcmanager.commands.open:DCIM
open web = bmcmanager.commands.open:Web
power cycle = bmcmanager.commands.power:PowerCycle
power off = bmcmanager.commands.power:PowerOff
power on = bmcmanager.commands.power:PowerOn
power reset = bmcmanager.commands.power:PowerReset
power status = bmcmanager.commands.power:PowerStatus
power switch lock = bmcmanager.commands.power:LockSwitch
power switch unlock = bmcmanager.commands.power:UnlockSwitch
ram check = bmcmanager.commands.ram:Check
ram get = bmcmanager.commands.ram:Get
server autoupdate disable = bmcmanager.commands.server.autoupdate:Disable
server autoupdate enable = bmcmanager.commands.server.autoupdate:Enable
server boot local = bmcmanager.commands.server.boot:Local
server boot pxe = bmcmanager.commands.server.boot:PXE
server diagnostics = bmcmanager.commands.server.server:Diagnostics
server identify = bmcmanager.commands.server.server:Identify
server info get = bmcmanager.commands.server.server:Info
server info idrac = bmcmanager.commands.server.server:IdracInfo
server jobs flush = bmcmanager.commands.server.server:FlushJobs
server list = bmcmanager.commands.server.list:List
server ssh = bmcmanager.commands.server.server:SSH
server status controllers = bmcmanager.commands.server.status:Controllers
server status get = bmcmanager.commands.server.status:Get
server status pdisks = bmcmanager.commands.server.status:PDisks
server status storage = bmcmanager.commands.server.status:Storage
server upgrade = bmcmanager.commands.server.server:Upgrade

[console_scripts]
bmcm = bmcmanager.cliff:main
bmcmanager = bmcmanager.cliff:main

